#################################
#   @@@        @@@        @@@   #
#                               #
#                               #
#                               #
#   @@@        @@@        @@@   #
#                               #
#                               #
#                               #
#   @@@        @@@        @@@   #
#                               #
#                               #
#   @@@        @@@        @@@   #
#                               #
#                               #
#                               #
#   @@@        @@@        @@@   #
#                               #
#                               #
#                               #
#   @@@        @@@        @@@   #
#################################