###########
#   @@@   #
#         #
#         #
#         #
#   @@@   #
#         #
#         #
#         #
#   @@@   #
###########