###########
#         #
#         #
#         #
#   MCM   #
#   @@@   #
#         #
#         #
#         #
#         #
###########