############################################
#   @@@        @@@        @@@        @@@   #
#                                          #
#                                          #
#                                          #
#   @@@        @@@        @@@        @@@   #
#                                          #
#                                          #
#                                          #
#   @@@        @@@        @@@        @@@   #
#                                          #
#                                          #
#   @@@        @@@        @@@        @@@   #
#                                          #
#                                          #
#                                          #
#   @@@        @@@        @@@        @@@   #
#                                          #
#                                          #
#                                          #
#   @@@        @@@        @@@        @@@   #
############################################