#######################################################
#   @@@        @@@        @@@        @@@       @@@    #
#                                                     #
#                                                     #
#                                                     #
#   @@@        @@@        @@@        @@@       @@@    #
#                                                     #
#                                                     #
#                                                     #
#   @@@        @@@        @@@        @@@       @@@    #
#                                                     #
#                                                     #
#   @@@        @@@        @@@        @@@       @@@    #
#                                                     #
#                                                     #
#                                                     #
#   @@@        @@@        @@@        @@@       @@@    #
#                                                     #
#                                                     #
#                                                     #
#   @@@        @@@        @@@        @@@       @@@    #
#                                                     #
#                                                     #
#   @@@        @@@        @@@        @@@       @@@    #
#                                                     #
#                                                     #
#                                                     #
#   @@@        @@@        @@@        @@@       @@@    #
#                                                     #
#                                                     #
#                                                     #
#   @@@        @@@        @@@        @@@       @@@    #
#                                                     #
#                                                     #
#   @@@        @@@        @@@        @@@       @@@    #
#                                                     #
#                                                     #
#                                                     #
#   @@@        @@@        @@@        @@@       @@@    #
#                                                     #
#                                                     #
#                                                     #
#   @@@        @@@        @@@        @@@       @@@    #
#                                                     #
#                                                     #
#   @@@        @@@        @@@        @@@       @@@    #
#                                                     #
#                                                     #
#                                                     #
#   @@@        @@@        @@@        @@@       @@@    #
#                                                     #
#                                                     #
#                                                     #
#   @@@        @@@        @@@        @@@       @@@    #
#######################################################