###################################################################################################################################################################################
#                                                                                                                                                                                 #
#                                                                                                                                                                                 #
#                                                                                                                                                                                 #
#                                                                                                                                                                                 #
#                                                                                                                                                                                 #
#                                                                                                                                                                                 #
#                                                                                                                                 @@@@@@@@@@@@@@@@@@@@@@                          #
#                                                                                                                                                                                 #
#                                                                                                                                                                                 #
#                                                                                                                                                                                 #
#                                                                          @@@                                                                                                    #
#                                                                                                                                        @@@                                      #
###################################################################                                                                                                               #
#                                                                                                                                                                                 #
#                                                                                                                                                                                 #
#                                                                                                                ##################################################################
#                                                                                                                                                                                 #
#                                                                                                                                                                                 #
#                                                                                         @@@                                                                                     #
#                                                                                                                                                                                 #
#                                                                                                                                                                                 #
#                                                                                                                                                                                 #
#                   @@@@@@@@@@@@@@@@@@@@@@@@@                                                                                                                                     #
#                                                                              @@@                                                                                                #
#                                                                                                                                                                                 #
#                                                                                                                                                                                 #
#                                                                                                                                                                                 #
#                                                                                                                                                                                 #
#                                                                                                                                 @@@@@@@@@@@@@@@@@@@@@@@                         #
#                                                                                                                                                                                 #
##################################################################             @@@                                                                                                #
#                                                                                                                                                                                 #
#                                                                                                                                                                                 #
#                                                                                                                @@@                                                              #
#                                                                                                                                                                                 #
#                       @@@@@@@@@@@@@@@@@@@@@@@@@@@@@@                                                                                                                            #
#                                                                                                                                                                                 #
#                                                                                     @@@                                                                                         #
#                                                                                                                                                                                 #
#                                                                                                                                                                                 #
#                                                                                                                                 @@@@@@@@@@@@@@@@@@@@@@                          #
#                                                                                                                                                                                 #
#                                                                                                                                                                                 #
#                                                                                                                                                                                 #
#                                               @@@@@@@@@@@@@@@@@@@@@@@@@@@@@@@@@@@@@@@@@                                                                                         #
#                                                                                                                                                                                 #
#                                                                                                                                                                                 #
#                                                                                                                                                                                 #
###################################################################################################################################################################################