######################
#   @@@        @@@   #
#                    #
#                    #
#                    #
#                    #
#                    #
#          C         #
#      @@@@@@@@      #
#                    #
#                    #
#                    #
#   @@@        @@@   #
#                    #
#                    #
#                    #
#                    #
#                    #
#                    #
#                    #
#                    #
######################