#000020000#
#         #
#         #
#@@@@@@@@@#
#         #
#         #
#000020000#