######################
#   @@@        @@@   #
#                    #
#                    #
#       M C   M      #
#   @@@@@@@@@@@@@@   #
#                    #
#                    #
#                    #
#                    #
######################