######################
#   @@@        @@@   #
#                    #
#                    #
#                    #
#   @@@        @@@   #
#                    #
#                    #
#                    #
#   @@@        @@@   #
######################