#########################################################################################
#                                                                                       #
#                                                                                       #
#                                                                                       #
#                                                                                       #
#        @@@@@@                                                                         #
#                        ############################               #####################
#                        #                          #                                   #
#                        #                          #                                   #
#                        #                          #                                   #
#                                                                                       #
#                                                        @@@@                           #
#        @@@@@@                  @@@@@@@@@@@@@                                          #
#                                                                                       #
#                        #                          #                                   #
#                        #                          #                     @@@@@@@@      #
#                        #                          #                                   #
#                        ############################                                   #
#                                                         @@@@@@@@                      #
#        @@@@@@                                                                         #
#                                                                                       #
#                                                                                       #
#                                                                                       #
#########################################################################################